line_plot
Level_glutton Step Total 17 10
Total_min Total_max Max_min Max_max Min_min Min_max Vector_op_min Vector_op_max Rvector_op_min Rvector_op_max
288 176 122 90 64 46 30 22 16 14 12 10 8 6 4 2 0 
288 258 232 210 192 156 138 108 90 66 54 36 16 10 4 2 0 
288 176 124 86 60 44 32 24 18 14 12 10 8 6 4 2 0 
288 258 232 210 192 156 138 108 90 66 54 36 14 8 4 2 0 
288 176 122 90 64 46 30 22 16 14 12 10 8 6 4 2 0 
288 258 212 182 120 104 86 60 44 34 28 20 16 10 4 2 0 
288 224 138 90 66 40 28 20 16 14 12 10 8 6 4 2 0 
288 180 150 114 96 86 76 56 38 28 22 16 12 10 4 2 0 
288 224 138 90 66 40 28 20 16 14 12 10 8 6 4 2 0 
288 180 150 114 96 86 76 56 38 28 22 16 12 10 4 2 0 
