line_plot
Level_glutton Step Total 26 10
Total_min Total_max Max_min Max_max Min_min Min_max Vector_op_min Vector_op_max Rvector_op_min Rvector_op_max
968 640 478 356 274 210 160 120 86 66 50 38 30 24 22 20 18 16 14 12 10 8 6 4 2 0 
968 926 886 850 816 736 692 616 582 522 456 392 364 300 242 222 172 132 86 68 50 18 6 4 2 0 
968 640 478 356 274 210 160 120 86 66 50 38 30 24 22 20 18 16 14 12 10 8 6 4 2 0 
968 926 886 850 816 736 692 616 582 522 456 392 364 298 278 220 162 122 94 70 50 18 6 4 2 0 
968 696 440 302 234 178 130 100 76 56 46 36 28 24 22 20 18 16 14 12 10 8 6 4 2 0 
968 842 622 432 392 354 310 258 196 184 152 124 116 110 98 92 82 72 60 44 34 16 10 6 2 0 
968 844 734 630 538 494 400 370 204 100 44 30 26 24 22 20 18 16 14 12 10 8 6 4 2 0 
968 640 492 432 298 248 196 152 140 108 98 86 74 66 56 50 40 34 26 22 16 12 8 4 2 0 
968 844 734 630 538 494 400 370 204 100 44 30 26 24 22 20 18 16 14 12 10 8 6 4 2 0 
968 640 492 432 298 248 196 152 140 108 98 86 74 66 56 50 40 34 26 22 16 12 8 4 2 0 
